NO ./images/NO.xpm
SO ./images/SO.xpm
WE ./images/DOOR.xpm
EA ./images/EA.xpm

F 255,0,255
C 255,255,0

            11
          1111111111
    1111111111111111111111111111111111111111111111111111111111111111111111111111111111111111
   1S010010010010010010010000000000000000000000000000000000000000000000000000000000000000001
   10000000100000000000000001011101111111111111111111111111111111111111111111111111111111101
1111000000000000001000000000001 101                                                      101
1000000100100000100000100100111 111                                                      101
1001010000000000000010010010001                                                          101
10000100000000000000100100110011111111111111111111111111111111111111111111111111111111111101
1111111111111111111111111000111            1111100000000000000000000000000000000000000000001
                      1000101111111111111111111101111111111111111111111111111111111111111111
                      1111100000000000000000000001
                          111111111111111111111111