NO ../images/NO.xpm
SO ../images/SO.xpm
EA ../images/EA.xpm
WE ../images/WE.xpm

F 107,138,54
C 204,229,255

   1111111111
   1001000001
   1000001111
1111000001
1000000111
1001010001
1E00010001
1111111111