NO ../images/NO.xpm
SO ../images/SO.xpm
EA ../images/EA.xpm
WE ../images/WE.xpm

F 107,138,54
C 204,229,255

   11111111111
   10010000001
   10000011101
1111000001 101
1000000111 111
1001010001
1E00010001
1111111111