NO ./images/N.xpm
SO ./images/W.xpm
WE ./images/S.xpm
EA ./images/ER.xpm

C 0,0,50
F 0,50,0
   11111111111111111111111111111111111111111111111111111111111111111111111111111111111111111
   10010010010010010010010010000000000000000000000000000000000000000000000000000000000000001
   10000000100W00000000000100011101111111111111111111011111111111111111111111111111111111101
1111000000000000001000000000001 101                 101                                  101
1000000100100100100100100100111 101                 101                                  101
1001010010010010010010010010001  1                  101                                  101
10000100000000111110100100110011111111111111111111111011111111111111111111111111111111111101
1111111111111111111111111000111            1111100000000000000000000000000000000000000000001
                      1000101111111111111111111101111111111111111111111111111111111011111111
                      1111100000000000000000000001
                          111111111111111111111111
                          111111
                          100011
                          111111