NO ./images/NO.xpm
SO ./images/SO.xpm
WE ./images/WE.xpm
EA ./images/EA.xpm

F
C 23,128,123
   11111111111111111111111111111111111111111111111111111111111111111111111111111111111111111
   1001001001001001001001001E000000000000000000000000000000000000000000000000000000000000001
   10000000100000000000000100011101111111111111111111011111111111111111111111111111111111101
1111000000000000001000000000001 101                 101                                  101
1000000100100100100100100100111 111                 101                                  101
1001010010010010010010010010001                     101                                  101
10000100000000111110100100110011111111111111111111111011111111111111111111111111111111111101
1111111111111111111111111000111            1111100000000000000000000000000000000000000000001
                      1000101111111111111111111101111111111111111111111111111111111111111111
                      1111100000000000000000000001
                          111111111111111111111111