               NO     ./images/NO.xpm
SO ./images/SO.xpm
WE ./images/WE.xpm
EA ./images/EA.xpm

     F   220  ,100,0
C 200,30,0
          1
        11111
1111111111111111111111111
1000000000110000000000001
1011000001110000000000001
100100000000000000000000111111111
111111111011000001110000000000001
110000000011000001110111111111111
  100000000111111111111111111
11110111111111011100000010001
11110111111111011101010010001
11000000110101011100000010001
1000000000000000110000010001
10000000000000001101010010001
11000001111101011111011110N01111
11110111    1110101 101111010001
111001111111111111111111111111111
  1000001000000010000000000001111111111
   100000000000000000000000000000000001                111111111111
   111111111111111111111111111111111111                100111111111
   111111111111111111111111111111111111                111111111111