NO ./images/NO.xpm
SO ./images/SO.xpm
EA ./images/EA.xpm
WE ./images/WE.xpm

F 107,138,54
C 204,229,255
          1
        11111
1111111111111111111111111111111111111111111111111111111111111111111111111111111111111111111
1000000000110010101010101010101010101101010101010101010101011010101010101010101010110101011
100100000111000000000S000000000000000000000000000000000000000000000000000000000000000000001
110100000000000000000000000000000000000000000000000000000000000000000000000000000000000000111111111
111111111011000001110000000000000000000000000000000000000000000000000000000000000000000000000000001
110000000011000001110111111100000000000000000000000000000000000000000000000000000000000000000011111
  1000000001111111000000000001100000000000100000000110000000000000000000000000000000000000000000111111
11100000000000101111100000000000000000000000000000000011100000000000000000101100000000000100000010001
11110111100000000000000000000000000000000000000000000000000000000000000000000000011111011101010010001
11000000110101011010101110010101110010101110010101110010101110010101110010101110010101110100000010001
10000000000000001100000100011111111111111111111111111111111111111111111111111111111111111111111111111
10000000000000001101010010001
11000001111101011111011110001111
11100111    1110101 101111010001
1110011111111111111111111111111111111111111111111111111111111111111111111111111111111111111111111
  10000010000000100000000000000000000000000000000000000000000000000000000000000000000000000001111111111
   1000000000000000000000000000000000000000000000000000000000000000000000000000000000000000000000000001                 1
    111111111111111111111111111111111111111111111111111111111111111111111111111111111111111111111111111                101
   111111111111111111111111111111111111                 1